"filename", "language", "Python", "comment", "blank", "total"
"/Users/JawanHaider/Documents/Projects/Collaborative/Dogar/flywasp-fd/src/RNN Implementation.py", "Python", 233, 81, 110, 424
"/Users/JawanHaider/Documents/Projects/Collaborative/Dogar/flywasp-fd/src/__init__.py", "Python", 0, 0, 1, 1
"/Users/JawanHaider/Documents/Projects/Collaborative/Dogar/flywasp-fd/src/data_preprocess/__init__.py", "Python", 0, 0, 1, 1
"/Users/JawanHaider/Documents/Projects/Collaborative/Dogar/flywasp-fd/src/data_preprocess/feature_engineering.py", "Python", 55, 52, 9, 116
"/Users/JawanHaider/Documents/Projects/Collaborative/Dogar/flywasp-fd/src/data_preprocess/preprocessing.py", "Python", 169, 186, 34, 389
"/Users/JawanHaider/Documents/Projects/Collaborative/Dogar/flywasp-fd/src/data_preprocess/rnn_data_prep.py", "Python", 235, 285, 70, 590
"/Users/JawanHaider/Documents/Projects/Collaborative/Dogar/flywasp-fd/src/main.py", "Python", 60, 36, 20, 116
"/Users/JawanHaider/Documents/Projects/Collaborative/Dogar/flywasp-fd/src/misc/1.0_fd_rnn_initial_exploration.py", "Python", 53, 35, 31, 119
"/Users/JawanHaider/Documents/Projects/Collaborative/Dogar/flywasp-fd/src/misc/2.0_fd_rnn_exploration.py", "Python", 111, 38, 50, 199
"/Users/JawanHaider/Documents/Projects/Collaborative/Dogar/flywasp-fd/src/misc/3.0_fd_rnn_implementation.py", "Python", 233, 81, 110, 424
"/Users/JawanHaider/Documents/Projects/Collaborative/Dogar/flywasp-fd/src/misc/main_v0.py", "Python", 132, 20, 17, 169
"/Users/JawanHaider/Documents/Projects/Collaborative/Dogar/flywasp-fd/src/misc/misc_utilities.py", "Python", 40, 133, 17, 190
"/Users/JawanHaider/Documents/Projects/Collaborative/Dogar/flywasp-fd/src/misc/test.py", "Python", 15, 1, 4, 20
"/Users/JawanHaider/Documents/Projects/Collaborative/Dogar/flywasp-fd/src/models/__init__.py", "Python", 0, 0, 1, 1
"/Users/JawanHaider/Documents/Projects/Collaborative/Dogar/flywasp-fd/src/models/baseline_models.py", "Python", 0, 0, 1, 1
"/Users/JawanHaider/Documents/Projects/Collaborative/Dogar/flywasp-fd/src/models/helpers_rnn.py", "Python", 119, 110, 41, 270
"/Users/JawanHaider/Documents/Projects/Collaborative/Dogar/flywasp-fd/src/models/old/rnn_model_v0.py", "Python", 95, 11, 28, 134
"/Users/JawanHaider/Documents/Projects/Collaborative/Dogar/flywasp-fd/src/models/rnn_model.py", "Python", 63, 182, 34, 279
"/Users/JawanHaider/Documents/Projects/Collaborative/Dogar/flywasp-fd/src/models/train_eval.py", "Python", 114, 152, 38, 304
"/Users/JawanHaider/Documents/Projects/Collaborative/Dogar/flywasp-fd/src/utils/__init__.py", "Python", 0, 0, 1, 1
"/Users/JawanHaider/Documents/Projects/Collaborative/Dogar/flywasp-fd/src/utils/utilities.py", "Python", 63, 29, 11, 103
"Total", "-", 1790, 1432, 629, 3851